1111111111111111111111
10P10000010E0000000001
10010000010000C0000001
1001001001111111111001
10000010000C0000000001
100C001000000000000C01
1111111111111111111111
