1111111111111111111111111111111
1P00100000001000001010000010001
1110111110101011111011101011101
1000100000101000100010001000101
1011111011111110101011111011101
1000101000001010001010000010001
1010101111101010111110111011101
1010001000000010000000001000001
1011101010111110111110111111101
1010001010000010100010101000001
1010111110101110111011101111111
1010000010101000100010000010001
1011101111101110111010111110101
10101000100000C0000000000010101
1010101111101111101111101010111
1010000010001000101010001010001
1011111011111011101010111111101
1000100000000000101010100000001
1011111010101011111010101110111
1000100010101010100010001000001
1111101010101110111011101011111
1000101010100010000000001010001
1011111111101010101010101011101
1000101010001010101010101000001
1110101011101111101111101110111
1000001010101010000010101000001
1011111010101011101010101010111
1000100000000000101010001010001
1011101011111011101110111110101
10000010100000000000101000001E1
1111111111111111111111111111111
