111111111111111111111111111111111111111111111111
100010000000000000000000000000000000000000000001
10P010C00000000000000000000000000000000000000C01
100010000000000000000000000000000000000000000001
100010001111111111111111111111111111111111110001
100010001000000000000000000000000000000000010001
1000100010E000000000000000000000000000000C010001
100010001000000000000000000000000000000000010001
100010001111111111111111111111111111111100010001
100010000000000000000000000000000000000000010001
100010C0000000000000000000000000000000000C010001
100010000000000000000000000000000000000000010001
100011111111111111111111111111111111111111110001
100000000000000000000000000000000000000000000001
10C000000000000000000000000000000000000000000C01
100000000000000000000000000000000000000000000001
111111111111111111111111111111111111111111111111
